TILEMAP
116 25 							-- Size of tile map in tiles
16 16 					                -- Tile size & block size
images/tileset.png 	                                -- Tilesheet
8 3							-- Number of tiles in tilesheet
                                                                                                                    
11111111111111111111111111111111111111111111111111111111111111111111111111111111111111111111111111111111111111111111
1                                                                                   D                              1
1                                                                                                                  1
1          8                                                                    9                    8     ;       1
1   11711111111                                                                1111111111111111111111111171111     1
1     7      B                                 CCC               <                        B     B        7      9  1
1     7                          G                        11111111111111                                 7      1111
1     7                     >                        =       B                      E                    7         1
111711111          1111111111111111111111111         CCC                                                 7         1
1  7                   A                                                                               1111111     1
1  7      @                                                         1117111111111111111111                         1
1  7     CCC                                   CCC                     7       A                 CC                1
1  7                                                                   7                                           1
1  7                                                                   7                     CCC    CCC      F     1
1111111111111111111711                               CCC               7                 :                         1
1         F    B   7                                                   7             11711                         1
1                  7              11111111711111111                    7               7                117111111111
1 9                7            11        7                            7  9            7                  7        1
111111             7          11          7                         11171111           7                  7        1
1    111           7        11            7                    ?       7             11711                7        1
1     1111         7      11D             7     111           111      7               7                  7        1
1              H   7                      7                            7               7                  7        1
1                  7                      7                            7               7                  7        1
11111111111111111111111111111111111111111111111111111111111111111111111111111111111111111111111111111111111111111111

